########################
#       #         #    #
# ##### # ####### # ## #
# #     # #     # # ## #
# # ##### # ### # #    #
#       #   #   # ######
####### ##### ####     #
#                     ##
# ########## ###########
#                      #
########################
